12 12
111111111111
1S0100000001
100101001101
110101111001
100000100001
100000100001
111110101001
100000101001
101111101001
100001001001
1001000010G1
111111111111
